#################
##    #   #    ## 
# !.   ###   .! #
# $# $ $ $ $ #$ #
#   # .! !. #   #
#  . #  $  # .  #
##  $ ##$## $  ## 
###.! # . # !.# # 
# #  ..$@$..  # #
# #.! # . # !.# # 
##  $ ##$## $  ## 
#  . #  $  # .  #
#   # .! !. #   #
# $# $ $ $ $ #$ #
# !.   ###   .! #
##    #   #    ## 
#################