  #####  
###   #  
#.@$  #  
### $.#  
#.##$ #  
# # . ###
#$ .$ $.#
#   .$  #
#########