############
# @    $  .#
######  ####
# .   $    #
#########  #
#.       $ #
#  #########
# $       .#
############