#########          ###########
#   @    ###########  #      #
###$ ##      ..#.         $$##
#            ..#.   $ $    $ #
# $ ##   ##        ######    #
#    $    $  ..#.            #
##############################