          ####          
         #    #         
        #  # $ #        
       #   $    #       
      #    #     #      
     #    ###     #     
    #      #    $# #    
   #                #   
  #     # ... #    @ #  
########################